0,1,1,2,1,2,0,1,1
7,5,3,1,2,1,0,1,1
2,4,2,3,2,1,0,1,1
6,1,8,2,1,2,0,1,1
5,3,1,6,1,2,0,1,1
4,1,2,1,0,0,0,1,1
0,1,1,2,1,2,0,1,1
7,5,3,1,2,1,0,1,1
2,4,2,3,2,1,0,1,1
6,1,8,2,1,2,0,1,1